AULAS 1, 2 e 3
I am from Rio de Janeiro - Eu sou do Rio de Janeiro.
I live in Sao Paulo - Eu moro em São Paulo.
Nice to meet you - Prazer em conhecer você.
this is - Esse é. Ex: Raquel, This is Pedro. Pedro, this is Raquel.
My friend - meu/minha amigo/amiga. 
Em inglês as palavras não mudam conforme o gênero. Ou seja, tanto meu amigo como minha amiga serão My friend.
Cool - legal. This is Raquel. She is cool.
in - no, na, nos, nas, em. Ceara is in Brazil.
Em inglês não usamos artigos antes de nomes próprios. Ou seja, em inglês não falamos "O Pedro",
falamos apenas "Pedro".
big country - país grande. Brazil is a big country. Em inglês o adjetivo sempre vem na frente do substantivo.
small city - cidade pequena. Sobral is a small city in Ceara.

A maioria das palavras que terminam com "idade" em português, se tornan em inglẽs através da substituição do "idade" por "ity". Ex: 
city - cidade
university - universidade
modernity - modernidade
priority - prioridade
curiosity - curiosidade
quality - qualidade
elasticity - elasticidade.
vulnerability - vulnerabilidade
formality - formalidade
personality - personalidade
reality - realidade
intensity - intensidade
brutality - brutalidade
integrity - integridade.

AULA 4
Antes de palavras que começam com vogais(ou com som de vogais como hour - hora) usamos an(um) ao invés de a(um).
I live in an apartment in Rio de Janeiro.
comfortable - confortável. My apartment is comfortable. It's fantastic.
house - casa. I live in a house.
small -pequeno/pequena. I live in a small house.
horrible(rorabou) - horrível. My house is horrible.
I live in a small apartment, in Messejana.

AULA 5

old - antigo/velho. I live in an old apartment.
new(niu) - novo. I live in a new apartment.
interesting - interessante. It's interesting. 
modern - moderno. My apartment is modern. It isn't old.
bad - ruim/mal. My apartment is modern. It isn't bad. It's good.

AULA 6

have - ter.
cell phone - celular. I have a cell phone.
cell phones - celulares. I have two cell phones.
computer - computador. I have a computer.
computers - computadores. I have two computers.
car - carro. I have a car.
cars - carros. I have two cars.
Podemos usar tanto "a" como "one" para nos referirmos a uma coisa. Só não podemos usar
"a" ao invés de "one" quando estivermos falando de um numero, por exemplo o 
numero da casa: 512 -> five, one, two. 
don't - negativa para verbos diferentes do verbo to be. I don't have a car.

AULA 7

to eat - comer
meat - carne. I don't eat meat.
Diferença sonora entre eat e it. eat tem um som de "i" mais agudo, então ficaria eat(ít), 
enquanto it tem um som mas de ê, entao ficaria it(êt).
fish -  peixe.
and - e. I eat meat and fish. 
egg - ovo.
eggs - ovos.
but - mas. I don't eat meat and fish, but I eat eggs.
everything - tudo. I eat everything.

LESSON 8

to like - gostar. I like 
fruit - fruta. I like fruit(eu gosto de fruta)
Note que em inglês não precisamos da preposição "de", ficando somente I like fruit.
to drink - beber.
beer - cerveja. I don't drink beer.
wine - vinho. I drink wine.
coffee - café. I don't like coffee.
milk - leite. I drink milk.
with - com. I drink coffee with milk.
water - água. I drink a lot of water(Eu bebo muita água)
soda - refrigerante. 




