LESSON 9(nine)

for breakfast - no café da manhã. //
bread - pão. I eat bread for breakfast.
A gente pode usar o verbo HAVE com o mesmo sentido tanto de EAT quanto de DRINK. Ou seja, podemos usar HAVE 
ao invés de EAT ou DRINK. Ex: I have bread for breakfast, but I don't have coffee.(Eu como pão no café da manhã, mas eu não bebo café)
for lunch - no almoço. //
salad - salada. I eat salad for lunch.
meals - refeições. I like all meals. //
Exercício do que eu como no café da manhã e no almoço:
I like breakfast and lunch, in really I like all meals. (Eu gosto do café da manhã e do almoço, na verdade, eu gosto de todas as refeições) 
I have bread with eggs for breakfast and for lunch I eat meat or chicken, rice, bean and sometimes fruits.
Note na frase acima que eu posso usar tanto EAT como HAVE.

LESSON 10 

dinner - jantar(substantivo). Dinner is good. - Jantar é bom.
have dinner - jantar(verbo). I have dinner at eight o'clock. - Eu janto ás 8h.
to have lunch - almoçar(verbo). She have lunch. - Ela almoça.
lunch - almoçar/almoço(substantivo). The lunch is good. - O almoço é(ou está) bom. 
have breackfast - tomo(a) café da manhã. //
at eight o'clock - ás 8 horas.
always - sempre. I always have dinner at eight o'clock.
usually - geralmente. I usually have lunch at one o'clock. //
sometimes - as vezes.
never - nunca.
six fifteen -  seis e quinze. I never have breackfast at six fifteen.
seven thirty - sete e meia. I sometimes have breakfast at seven thirty.
midday - meio dia. I never have lunch at midday.
nine forty-five - nove. 

LESSON 11

to study - estudar.
english - inglês. I study english.
at university - na universidade. I study english at university.
to work - trabalhar. I work at home.
office - escritório. I work in an office.
to speak - falar.
house - casa(uma casa qualquer).
at home - em casa(Essa casa significa seu lar). Home sweet home. Lar doce lar.
to go - ir. I go to the gym.
every day - todo dia. I go to the gym every day.

LESSON 12

you - você. 
do - para indicar pergunta com os pronomes I, you, we, they. Do you work in an office?(Você trabalha em um escritório?)
Em inglês, para indicar uma interrogação usamos a palavra "do" no início das frases, 
e o "do" sempre acompanha o pronome(por exemplo, you). Na interrogação o sujeito o 
verbo e o complemento continuam nas mesmas posições que estavam na afirmativa. // 
does - para indicar pergunta com os pronomes he/she/it. //
Does she work?
Do you work? - Você trabalha?
Do you study? - Você estuda?
Do you have lunch at university? - Você almoça na universidade?
where - onde. Where do you work?(Onde você trabalha?)
what time - que horas. What time do you go to the gym?(Que horas você vai para a academia?) //
when - quando. When do you work?(Quando você trabalha?)
What time do you have lunch? - Que horas você almoça? //
What time is it? - Que horas são? //
I usually have lunch at midday.
to do - fazer. What do you do?(O que você faz?)
teacher - professor. I'm a teacher.
singer - cantor(a) - You're a singer.

LESSON 13

married - casado(a). I'm married. //
single - solteiro(a). I'm not single.
divorced - divorciado(a). I'm not divorced.
engaged - noivo(a). I was engaged a year ago. // 
OBS: A frase "I went engaged a year ago" não está correta em inglês. Isso ocorre porque o verbo "go" não é comumente usado com o adjetivo "engaged" 
para se referir a ficar noivo em inglês. É mais comum usar o verbo "to be" no passado, como em "I was engaged a year ago". //

LESSON FOURTEEN

to have - ter.
brother - irmão. 
brothers - irmãos. I have two brothers.
sister - irmã. I don't have a brother or a sister. 	 
sisters - irmãs. I have two sisters.
siblings - irmãos + irmãs. I have four siblings, two sisters and two brothers. //
son - filho. //
sons - filhos. I don't have sons. //
daughter - filha. I don't have a daughter or a son. //
daughters - filhas. //
child - criança. //
children - filhos + filhas. My mother has five children, three sons and two daughters. // 
family - familia.
small - pequeno(a). I don't have a small family.
big - grande. I have a big family.
OBS: os adjetivos sempre vem antes dos substantivos e nunca vão ao plural, também não mudam para masculino nem feminino.

LESSON FIFTEEN

twenty - vinte. I'm twenty-six years old(Eu tenho 26 anos de idade)
thirty - trinta. My brother is thirty(Meu irmão tem 30)
forty - quarenta.   
Fifty - cinquenta. My mother is fifty-three years old(Minha mãe tem 53 anos de idade) //
sixty - My mother and my father are sixty-one(Minha mãe e meu pai tem 61) 
seventy
eighty
ninety

LESSON SIXTEEN

to live - viver/morar. She lives in a house. //
doesn't - negativa para he, she e it. He doesn't live in a house and he doesn't work.
Observe que se a frase for afirmativa e for na terceira pessoa do singular(he, she, it) 
existe uma conjugação do verbo live, ficando lives. Porém se for uma frase negativa então
não conjugamos o verbo, ao invés disso acrescentamos doesn't para a terceira pessoa do 
singular(he, she, it) e don't para os outros. //
